==========
=        =
=        =
=        =
=        =
=        =
=        =
=        =
=       *=
==========